030000000000
020000000000
020000000000
022200222224
000200200000
000222200000
000000000000
000000000000
