030000000000
020000002220
020000002020
022200002024
000200002000
000200002000
000222222000
000000000000
